#domain
hospital
#levelname
BFSfriendly
#colors
blue: 0, 1
#initial
++++++++++++++++
+              +
+              +
+              +
+      01      +
+              +
+              +
+              +
++++++++++++++++
#goal
++++++++++++++++
+              +
+              +
+       01     +
+              +
+              +
+              +
+              +
++++++++++++++++
#end