#domain
hospital
#levelname
MAPF02
#colors
blue: 0,1,2
#initial
++++++++++
+0       +
+1    ++++
+        +
+ 2   ++ +
+      + +
++++++++++
#goal
++++++++++
+        +
+     ++++
+        +
+     ++ +
+      +0+
++++++++++
#end
