#domain
hospital
#levelname
SAD2
#colors
blue: 0, A, B, C, D
#initial
++++++++++
+0C      +
+BD   ++++
+        +
+     ++A+
+      + +
++++++++++
#goal
++++++++++
+        +
+     ++++
+        +
+     ++ +
+      +A+
++++++++++
#end
